12:12
51  0   17  96   0   0    0    38   64   17   17   54
0   0   17  0    0   17   17   17   17   17   17   0
0   0   17  0    37  17   0    38   18   18   17   0 
0   17  17  0    35  17   0    0    37   18   17   0
0   17  0   0    18  0    96   0    33   18   17   96
0   17  0   0    0   0    0    17   38   0    17   0
0   0   0   17   0   17   17   17   0    18   17   0
0   0   0   18   0   17   17   17   0    33   17   0
0   18  0   18   0   17   17   17   0    18   17   0
35  18  0   37   17  17   17   17   33   18   17   0
34  18  0   0    0   34   0    0    0    0    17   0
33  18  0   0    0   0    0    96    0    0    0    0 