12:12
59  0    0    36   38   38   38   38   38    38    38    38
64  38   34   36   38   38   38   38   38    38    38    38
62  38   34   36   38   38   38   38   38    38    38    38
38  38   34   36   38   38   38   38   38    38    38    38
38  38   34   36   38   38   38   38   38    38    38    38
38  38   34   36   38   38   38   38   38    38    38    38
38  38   34   36   38   38   38   38   38    38    38    38
38  38   34   36   38   38   38   38   38    38    38    38
38  38   34   36   38   38   38   38   38    38    38    38
38  38   34   36   38   38   38   38   38    38    38    38
38  38   34   36   38   38   38   38   38    38    38    38
38  38   34   36   38   38   38   38   38    38    38    38