12:12
49  0   0   0   0   38  0   0   0   0   0   0
18  18  18  18  18  18  18  18  96  0   0   0
18  18  18  18  18  0   0   34  0   17  17  35
18  64  0   96  18  0   0   0   34  17  17  35
18  0   0   17  0   0   0   0   0   17  17  36
18  18  0   0   0   0   0   38  17  17  17  17
18  18  17  17  0   0   0   0   17  17  17  17
18  38  17  17  17  0   17  17  17  17  17  17
18  35  17  52  17  0   37  17  17  17  17  17
18  33  17  35  17  0   17  0   0   35  38  36
18  33  0   0   33  0   0   0   18  18  18  18
18  0   0   37  0   0   0   0   18  18  18  18