12:12
53  0   0   0   0   38  0   33   37   18   0   56
0   0   17  18  18  18  18  18   17   96    0   17
0   0   17  18  18  0   0   34   35   0    17  64
0   0   17  17  18  0   0   0    34   17   17   0
0   0   17  17  0   0   0   0    0    17   17   0
0   0   17   0  0   0   0   38   17   17   17   96
0   0   0    0  0   0   0   0    17   17   17   0
0   17  17  17  17  0   17  17   17   17   17   0
0   17  17  17  37  0   17  17   17   17   0    0
0   17  17  17  17  0   17  0    0    35   17   36
0   17  18  18  33  0   0   0    18   18   18   0
38  17  18  18  0   0   96   0    0    0    0    0