12:12
61  0   0   0   17  0   0   0   0    0    19   20
0   0   0   0   17  0   0   17  0    0    17   17
0   0   17  0   0   17  0   17  0    0    0    0
0   0   17  0   0   0   0   17  0    0    0    0
17  17  17  17  0   17  17  17  0    0    0    0
0   0   17  0   0   0   0   0   17   17   0    17 
0   0   17  0   0   0   0   0   17   0    0    0
0   0   0   0   17  17  0   17  0    0    17   0
0   17  0   0   17  0   0   17  0    17   17   0
0   17  0   0   17  0   0   0   0    0    17   0
0   17  17  17  17  17  17  0   17   0    0   0
0   0   0   0   0   0   0   0   0    0    0   0
