12:12
57  0   0   17  17  0   0   0   17   96    0    34
0   0   17  0   33  0   17  0   0    0    17   0
17  0   0   0   17  0   0   17  17   17   0    0
0   17  17  17  17  0   17  35  17   0    17   0
17  35  0   96   17  0   0   0   17   0    0    0
0   0   17  0   0   96   17  0   0    0    17   17
0   17  0   38  17  0   17  0   17   17   64   0
37  0   17  0   0   0   17  34  0    0    17   33
17  96   17  0   17  17  0   0   17   17   17   0
34  0   0   17  0   0   0   0   38   17   17   36
17  17  0   33  17  0   17  17  17   0    0    0
0   17  60  0   17  0   0   0   0    96    17   34