12:12
55  0   17  33  18  0   0   18  18   0    0    38
0   0   18  0   0   0   96   18  18   0    18   17
0   0   0   0   17  0   0   0   0    0    18   38
0   0   0   0   17  17  37  17  0    0    18   0
0   0   0   17  34  17  17  17  34   18   18   0
0   0   17  0   0   0   17  17  17   0    17   0
0   17  0   0   96   0   0   0   0    0    17   0
0   0   0   0   0   0   0   0   0    0    33   0
0   0   0   0   18  35  18  0   0    0    17   0
18  96  17  18  18  18  0   0   0    0    17   96
0   35  0   0   0   0   0   0   0    0    17   0
64  0   0   0   0   0   0   0   96    0    17   58