12:12
0   0   0   37  0   0   0   0   0   0   0   0
17  17  17  0   17  0   17  17  17  17  0   0
0   0   0   0   17  35  17  0   0   17  0   0
36  0   96  0   17  34  17  0   0   17  0   0
0   0   0   0   17  35  17  0   0   17  0   0
0   64  0   0   17  17  17  0   0   17  0   0
0   0   0   0   0   0   0   0   0   17  0   0
0   18  34  18  0   0   0   96  0   17  0   0
0   18  18  18  0   0   0   0   0   17  0   0
0   0   0   0   0   0   0   0   0   17  0   0
33  17  17  17  17  17  17  17  17  17  38  0
34  0   50  0   0   0   0   0   0   0   0   0